..@@@@...@@@@...@@@@..
.......@......@.......
..@@@@.@.@@@@.@.@@@@..
.......@......@.......
..@@@@...@@@@...@@@@..
.......@......@.......
..@@@@.@.@@@@.@.@@@@..
.......@......@.......
..@@@@...@@@@...@@@@..
